┌────────────────┬──────────────────────────────────────────────────┬────────────────────────────────────────────────┬────────────────────────────────────────────────────────────────────────────────────────────────────────────────────────────────────────────────────────────────────────────────────────────────────────────────────────────────────────────────────────────────────────────────────────────────────────────────────────────────────────────────────────────────────────────────────────────────────────────────────────────────────────────────────────────────────────────────────────────────────────────────────────────────────────────────────────────────────────────────────────────────────────────────────────────────────────┐
│                │                                                  │                                                │                                                                                                                                                                                                                                                                                                                                                                                                                                                                                                                                                                                                                                        │
│                │                                                  │                                                │                                                                                                                                                                                                                                                                                                                                                                                                                                                                                                                                                                                                                                        │
│              .─┴─.                                              .─┴─.                                            .─┴─.                                                                                                                                                                                                                                                    ⣰⣾⣾⣿⣿⣿⣿⣆                                                                                                                                                                                                                                                                                                                                                                          │
│             (     )                                            (     )                                          (     )                                                                                                                                                                                                                                                 ⣰⣾⣾⣾⣾⡀⣾⣾⣾⣾⣾⣷⣄                                                                                                                                                                                                                                                                                                                      ╭──╮                                             │
│              '───'                                              '───'                                            '───'                                                                                                                                                                                                                                               ⢀⣰⣾⣾⣾⣾⣾⣾⣾⣾⣾⣾⣾⣾⣾⣾⣾⣷⣄                                                                                                                                                                                                                                                                                                                   ╽▐▌╽                                             │
│                                                                                                                                                                                                                                                                                                                                                                    ⣰⣾⣾⣾⣾⣾⣾⣾⣾⣾⣾⣾⣾⣾⣾⣾⣾⣾⣾⣾⣾⣿⣷⣄                                                                                                                                                                                                                                                                                                               ╭╯  ╰╮                                            │
│                                                                                                                                                                                                                                                                                                                                                                 ⢀⣰⣾⣾⣾⣾⣾⣾⣾⣾⣾⣾⣾⣾⣾⣾⣾⣾ ⣾⣾⣾⣾⣾⣾⣾⣾⣾⣷⣄                                                                                                                                                                                                                                                                                                          ╭─╯    ╰─╮                                          │
│         ┌────────────────────────────────┐     ┌────────────────────────────────┐     ┌────────────────────────────────┐                                                                                                                                                                                                    ⣴⣿⣿⣷⣾⣿⣿⣆                         ⣰⣾⣾⣾⣾⣾⣾ ⣾⣾⣾⣾⣾⣾⣾⣾⣾ ⣾⣾⣾⣾⣾ ⣾⣾⣾⣾⣾⣾⣾⣾⣾⣾⣶⣄⡀                                                                                                                                                                                                                                                                                                    ╭─╯        ╰─╮                                        │
│         │                                │     │                                │     │                     ▷▷         │                                                                                                                                                                                                   ⢾⣿⡿⢿⣿⣿⣿⠟                      ⢀⣰⣾⣾⣾⣾⣾⣾ ⠟ ⡞    ⣾     ⣾⣾ ⣾⣾⣾⣾⣾ ⣾⣾⣾⣾⣾ ⣾⣾⣾⣾⣷⣄                                                                                                                                                                                                                                                                                               ╭──╯ ▞▞▞▞▞▞▞▞▞▞ ╰──╮                                     │
│         │  ╔═════╗   ═══╦═══  ╔══════╗   │     │  ╔═════╗   ═══╦═══  ║║  ║║     │     │                     ▷ ▷▷       │                                                                                                                                                                                                                              ⢀⣰⣾⣾⣾⣾⣾⣾⣾⠟       ⡞          ⣾   ⣾⣾⣾ ⣾      ⠈⠻⣾⣷⣦⣄                                                                                                                                                                                                                                                                                           ╭┴──────────────────┴╮                                    │
│         │  ║     ║      ║     ║      ║   │     │  ║     ║      ║     ║║  ║║     │     │  ▷▷▷▷▷▷▷▷▷▷▷▷▷▷▷▷▷▷▷▷   ▷▷     │                                                             ╔═══════╗    ╔═══════╗    ╔═══════╗    ╔════╗                                                                                                                 ⢀⣰⣾⣾⠟   ⠟                         ⣾⡞               ⡌⢿⣷⣄                                                                                                                                                                 ╔═══════╗                                           ║       ║                                                          │ ◻ ◻ ◻ ◻ ▥▥ ◻ ◻ ◻ ◻ │                                    │
│         │  ║            ║     ║      ║   │     │  ║     ║      ║     ║║  ║║     │     │  ▷                        ▷▷   │                                                             ║       ║    ║       ║    ║       ║    ║    ╚═╗                                                                                                             ⣀⣾⣾⣾⠟                              ⡞                    ⠈⢿⣷⣄                                                                                                                                                              ║       ║                                           ║       ║                                                        ╭─┤  ╭──────────────╮  ├─╮                                  │
│         │  ╚═════╗      ║     ╠══════╣   │     │  ╠═══╦═╝      ║     ║║  ║║     │     │  ▷▷▷▷▷▷▷▷▷▷▷▷▷▷▷▷▷▷▷▷   ▷▷     │                                                             ║       ║    ║       ║    ║       ║    ║      ╚╗                                                                                                        ⢀⣰⣾⣾⣾⣾⠟                                                        ⠈⠻⣦⡀                                                                                                                                                           ║       ║                 ║            ║       ║    ║       ║                      ╔═══════║                         ├─┤  ├──────────────┤  ├─┤                                  │
│         │        ║      ║     ║      ║   │     │  ║   ╚═╗      ║                │     │                     ▷ ▷▷       │                                                             ║       ║    ║       ║    ║       ║    ║       ║                                                                                                    ⢀⣰⣾⣾⣾⣾⠟                                                              ⠈⠻⣷⣦⣄                                                                                                                                                        ║       ║                 ║            ║       ║    ║       ║                 ║    ║       ║    ║                    │ │  │  █ █    █ █  │  │ │                                  │
│         │  ╚═════╝      ║     ║      ║   │     │  ║     ║      ║     ║║  ║║     │     │                     ▷▷         │                                                             ╠═════╦═╝    ║       ║    ╠═══════╣    ║       ║                                                                                              ⣀⣀⣀⣀⣀⠤⣾⣾⣾⠟                                                                    ⠈⠻⣷⣦⣄                                                                                                                                                     ╠═════╦═╝    ║       ║    ╠══════╗     ║       ║    ╠═════╦═╝    ╔═══════║         ║       ║                         │ │  │  █ █    █ █  │  │ │                                  │
│         └────────────────────────────────┘     └────────────────────────────────┘     └────────────────────────────────┘                                                             ║     ╚═╗    ║       ║    ║       ║    ║      ╔╝                                                                          ╭──────────────────────────────────────────────────────────────────────────────────────────────────────────────────────────────────────────────────────────────────────────────────────────────────╮                                                        ║     ╚═╗    ║       ║    ║      ╚╗    ╚═══════╣    ║     ╚═╗    ║       ║    ║    ╚═══════╣    ║                    │ │  │  █ █    █ █  │  │ │                                  │
│                                                                                                                                                                  ┌────────────┐      ║       ║    ║       ║    ║       ║    ║    ╔═╝       ┌────────┐                                               ╭──────────╯                                                                                                                                                                                                  ╰───────────╮                                            ║       ║    ║       ║    ║       ║            ║    ║       ║    ║       ║    ║            ║    ║                    │ │  ├──────────────┤▥▥│ │                                  │
│                                                                                                                                                                  │            │      ║       ║    ╚═══════╝    ║       ║    ╚════╝         │        │                                          ╭────╯                                                                                                                                                                                                                         ╰────╮                                       ║       ║    ╚═══════║    ╚═══════╝    ════════╝    ║       ║    ╚═══════║    ║    ════════╝    ║                  ╭─┴─┴──┴──────────────┴──┴─┴─╮                                │
│                                                                                                                                                                  │            │                                                            │        │                                     ╭────┤      ╭─────╮                                                                                                                                                                                                         ╭─────╮      ├────╮                                                                                                                                                   ╭─╯                       ◺◺   ╰─╮                              │
│                      ████████                       ████████              ████████                  ████████                                                     └────────────┘                                                            │        │                                ╭────┴────╯      │╭───╮│    ╭────╮     ╭────╮     ╭────╮     ╭────╮     ╭────╮     ╭────╮     ╭────╮     ╭────╮     ╭────╮     ╭────╮     ╭────╮     ╭────╮     ╭────╮     ╭────╮     ╭────╮     ╭────╮     ╭────╮     ╭────╮    │╭───╮│      ╰────┴────╮                                                                                                                                              │    ╭──────────────────────╮◺◺  │                              │
│                      ████████      ░                ████████      ▓░▓     ████████                  ████████      ░                                                                                                                        │        │                           ╭────╯                ││   ││    │    │     │    │     │    │     │    │     │    │     │    │     │    │     │    │     │    │     │    │     │    │     │    │     │    │     │    │     │    │     │    │     │    │     │    │    ││   ││                ╰────╮                                                                                                                                         │    │  ▟█▙    ▟██▙    ▟█▙  │ ◸◸◸│                              │
│                      ▀▀▀▜▛▀▀▀   █▘ ░                ▀▀▀▜▛▀▀▀   █  ▓░▓  █  ▀▀▀▜▛▀▀▀                  ▀▀▀▜▛▀▀▀   █▘ ░                            ┌────────────┐                                                                              │        │                      ╭────╯                     │╰───╯│    │    │     │    │     │    │     │    │     │    │     │    │     │    │     │    │     │    │     │    │     │    │     │    │     │    │     │    │     │    │     │    │     │    │     │    │    │╰───╯│                     ╰────╮                                                                                                                                    │    │ ▟███▙  ▟████▙  ▟███▙ │    │                              │
│                 ══╦═════▝▘══════════╦══        ══╦═════▝▘════════════════════▝▘═════╦══        ══╦═════▝▘══════════╦══                         │            │                                                                              │      ◯ │               ╭──────╯                          │     │    ╰────╯     ╰────╯     ╰────╯     ╰────╯     ╰────╯     ╰────╯     ╰────╯     ╰────╯     ╰────╯     ╰────╯     ╰────╯     ╰────╯     ╰────╯     ╰────╯     ╰────╯     ╰────╯     ╰────╯     ╰────╯    │     │                          ╰──────╮                                                                                                                             │    │ █████  ██████  █████ │    │                              │
│                   ║                 ║            ║                                  ║            ║                 ║                           │            │                                                                              │        │             ╭─╯                                 │     │                                                                                                                                                                                                         │     │                                 ╰─╮                                                                                                                           │    │ █████  ██████  █████ │    │                              │
│                   ║                 ║            ║                                  ║            ║                 ║        ┌────────────┐     └────────────┘                                                                              │        │             │                                   │     │                                                                                                                                                                                                         │     │                                   │                                                                                                                           │    │ █████  ██████  █████ │    │                              │
│                   ║                 ║            ║                                  ║            ║                 ║        │            │                                                                                                 │        │             │                                   ╰─────╯                                                                                                                                                                                                         ╰─────╯                                   │                                                                                                                           │    │ █████  ██████  █████ │    │                              │
│                   ╨                 ╨            ╨                                  ╨            ╨                 ╨        │            │                                                                                                 │        │             ╰───────────────┬───┬───┬───┬───────────────────────────────────────────────────────┬───┬───┬───┬─────────────────────────────────────────────────────────────────────────────────────────────┬───┬───┬───┬───────────────────────────────────────────────────────┬───┬───┬───┬───────────────╯                                                                                                                           ╰────┴─▀▀▀▀▀──▀▀▀▀▀▀──▀▀▀▀▀─┴────╯                              │
│                                                                                                                             └────────────┘                                                                                                 └────────┘                             ╰◯◯◯╯   ╰◯◯◯╯                                                       ╰◯◯◯╯   ╰◯◯◯╯                                                                                             ╰◯◯◯╯   ╰◯◯◯╯                                                       ╰◯◯◯╯   ╰◯◯◯╯                                                                                                                                                                                                           │
└─────────────────────────────────────────────────────────────────────────────────────────────────────────────────────────────────────────────────────────────────────────────────────────────────────────────────────────────────────────────────────────────────────────────────────────────────────────────────────────────────────────────────────────────────────────────────────────────────────────────────────────────────────────────────────────────────────────────────────────────────────────────────────────────────────────────────────────────────────────────────────────────────────────────────────────────────────────────────────────────────────────────────────────────────────────────────────────────────────────────────────────────┘