┌───────────────────┬──────────────────────────────────────────────────┬────────────────────────────────────────────────┬────────────────────────────────────────────────────────────────────────────────────────────────────────────────────────────────────────────────────────────────────────────────────────────────────────────────────────────────────────────────────────────────────────────────────────────────────────────────────────────────────────────────────────────────────────────────────────────────────────────────────────────────────────────────────────────────────────────────────────────────────────────────────────────────────────────────────────────────────────────────────────────────────────────────────────────────────────┐
│                   │                                                  │                                                │                                                                                                                                                                                                                                                                                                                                                                                                                                                                                                                                                                                                                                        │
│                   │                                                  │                                                │                                                                                                                                                                                                                                                                                                                                                                                                                                                                                                                                                                                                                                        │
│                 .─┴─.                                              .─┴─.                                            .─┴─.                                                                                                                                                                                                                                                    ⣰⣾⣾⣿⣿⣿⣿⣆                                                                                                                                                                                                                                                                                                                                                                          │
│                (     )                                            (     )                                          (     )                                                                                                                                                                                                                                                 ⣰⣾⣾⣾⣾⡀⣾⣾⣾⣾⣾⣷⣄                                                                                                                                                                                                                                                                                                                      ╭──╮                                             │
│                 '───'                                              '───'                                            '───'                                                                                                                                                                                                                                               ⢀⣰⣾⣾⣾⣾⣾⣾⣾⣾⣾⣾⣾⣾⣾⣾⣾⣷⣄                                                                                                                                                                                                                                                                                                                   ╽▐▌╽                                             │
│                                                                                                                                                                                                                                                                                                                                                                       ⣰⣾⣾⣾⣾⣾⣾⣾⣾⣾⣾⣾⣾⣾⣾⣾⣾⣾⣾⣾⣾⣿⣷⣄                                                                                                                                                                                                                                                                                                               ╭╯  ╰╮                                            │
│                                                                                                                                                                                                                                                                                                                                                                    ⢀⣰⣾⣾⣾⣾⣾⣾⣾⣾⣾⣾⣾⣾⣾⣾⣾⣾ ⣾⣾⣾⣾⣾⣾⣾⣾⣾⣷⣄                                                                                                                                                                                                                                                                                                          ╭─╯    ╰─╮                                          │
│      ┌────────────────────────────────┐        ┌────────────────────────────────┐        ┌────────────────────────────────┐                                                                                                                                                                                                    ⣴⣿⣿⣷⣾⣿⣿⣆                         ⣰⣾⣾⣾⣾⣾⣾ ⣾⣾⣾⣾⣾⣾⣾⣾⣾ ⣾⣾⣾⣾⣾ ⣾⣾⣾⣾⣾⣾⣾⣾⣾⣾⣶⣄⡀                                                                                                                                                                                                                                                                                                    ╭─╯        ╰─╮                                        │
│      │                                │        │                                │        │                     ▷▷         │                                                                                                                                                                                                   ⢾⣿⡿⢿⣿⣿⣿⠟                      ⢀⣰⣾⣾⣾⣾⣾⣾ ⠟ ⡞    ⣾     ⣾⣾ ⣾⣾⣾⣾⣾ ⣾⣾⣾⣾⣾ ⣾⣾⣾⣾⣷⣄                                                                                                                                                                                                                                                                                               ╭──╯ ▞▞▞▞▞▞▞▞▞▞ ╰──╮                                     │
│      │  ╔═════╗   ═══╦═══  ╔══════╗   │        │  ╔═════╗   ═══╦═══  ║║  ║║     │        │                     ▷ ▷▷       │                                                                                                                                                                                                                              ⢀⣰⣾⣾⣾⣾⣾⣾⣾⠟       ⡞          ⣾   ⣾⣾⣾ ⣾      ⠈⠻⣾⣷⣦⣄                                                                                                                                                                                                                                                                                           ╭┴──────────────────┴╮                                    │
│      │  ║     ║      ║     ║      ║   │        │  ║     ║      ║     ║║  ║║     │        │  ▷▷▷▷▷▷▷▷▷▷▷▷▷▷▷▷▷▷▷▷   ▷▷     │              ┌──────────┐                                   ╔═══════╗                                                                                                                                                     ⢀⣰⣾⣾⠟   ⠟                         ⣾⡞               ⡌⢿⣷⣄                                                                                                                                                                 ╔═══════╗                                           ║       ║                                                          │ ◻ ◻ ◻ ◻ ▥▥ ◻ ◻ ◻ ◻ │                                    │
│      │  ║            ║     ║      ║   │        │  ║     ║      ║     ║║  ║║     │        │  ▷                        ▷▷   │              │ □ □  □ □ │                                   ║       ║                                                                                                                                                   ⣀⣾⣾⣾⠟                              ⡞                    ⠈⢿⣷⣄                                                                                                                                                              ║       ║                                           ║       ║                                                        ╭─┤  ╭──────────────╮  ├─╮                                  │
│      │  ╚═════╗      ║     ╠══════╣   │        │  ╠═══╦═╝      ║     ║║  ║║     │        │  ▷▷▷▷▷▷▷▷▷▷▷▷▷▷▷▷▷▷▷▷   ▷▷     │              │          │                                   ║       ║                                      ║                                                                                                        ⢀⣰⣾⣾⣾⣾⠟                                                        ⠈⠻⣦⡀                                                                                                                                                           ║       ║                 ║            ║       ║    ║       ║                      ╔═══════║                         ├─┤  ├──────────────┤  ├─┤                                  │
│      │        ║      ║     ║      ║   │        │  ║   ╚═╗      ║                │        │                     ▷ ▷▷       │              └──────────┘                                   ║       ║                                      ║                                                                                                    ⢀⣰⣾⣾⣾⣾⠟                                                              ⠈⠻⣷⣦⣄                                                                                                                                                        ║       ║                 ║            ║       ║    ║       ║                 ║    ║       ║    ║                    │ │  │  █ █    █ █  │  │ │                                  │
│      │  ╚═════╝      ║     ║      ║   │        │  ║     ║      ║     ║║  ║║     │        │                     ▷▷         │                                                             ╠═════╦═╝    ╔═══════╗    ╔═══════║     ╔══════╣                                                                                              ⣀⣀⣀⣀⣀⠤⣾⣾⣾⠟                                                                    ⠈⠻⣷⣦⣄                                                                                                                                                     ╠═════╦═╝    ║       ║    ╠══════╗     ║       ║    ╠═════╦═╝    ╔═══════║         ║       ║                         │ │  │  █ █    █ █  │  │ │                                  │
│      └────────────────────────────────┘        └────────────────────────────────┘        └────────────────────────────────┘                                                             ║     ╚═╗    ║       ║    ║       ║    ╔╝      ║                                             ╭─────────────────────────────────────────────────────────────────────────────────────────────────────────────────────────────────────────────────────────────────────────────────────────────────────────────────────────────────────────────────────────────╮                          ║     ╚═╗    ║       ║    ║      ╚╗    ╚═══════╣    ║     ╚═╗    ║       ║    ║    ╚═══════╣    ║                    │ │  │  █ █    █ █  │  │ │                                  │
│                                                                                                                                                                                         ║       ║    ║       ║    ║       ║    ║       ║        ┌────────┐                         ╭─┼─╮                                                                                                                                                                                                                                                         ╭─┼─╮                        ║       ║    ║       ║    ║       ║            ║    ║       ║    ║       ║    ║            ║    ║                    │ │  ├──────────────┤▥▥│ │                                  │
│                                                                                                                                                                         ┌──────────┐    ║       ║    ╚═══════╝    ╚═══════║    ╚═══════╝        │        │                       ╭─╯ │ ╰──╮                                                                                                                                                                                                                                                   ╭──╯ │ ╰─╮                      ║       ║    ╚═══════║    ╚═══════╝    ════════╝    ║       ║    ╚═══════║    ║    ════════╝    ║                  ╭─┴─┴──┴──────────────┴──┴─┴─╮                                │
│                                                                                                                                                                         │ □ □  □ □ │                                                            │        │                     ╭─╯   ╰─╮  ╰─╮            ⣠⣤⣤⣤⣤⣤⣄                                                                                                                                                                                                         ⣠⣤⣤⣤⣤⣤⣄            ╭─╯  ╭─╯   ╰─╮                                                                                                                                     ╭─╯                       ◺◺   ╰─╮                              │
│                         ████████                       ████████              ████████                  ████████                                                         │          │                                                            │        │                   ╭─╯       ╰─╮  ╰─╮          ⣿⠋⠉⠉⠉⠙⣿    ⣠⣤⣤⣤⣤⣄     ⣠⣤⣤⣤⣤⣄     ⣠⣤⣤⣤⣤⣄     ⣠⣤⣤⣤⣤⣄     ⣠⣤⣤⣤⣤⣄     ⣠⣤⣤⣤⣤⣄     ⣠⣤⣤⣤⣤⣄     ⣠⣤⣤⣤⣤⣄     ⣠⣤⣤⣤⣤⣄     ⣠⣤⣤⣤⣤⣄     ⣠⣤⣤⣤⣤⣄     ⣠⣤⣤⣤⣤⣄     ⣠⣤⣤⣤⣤⣄     ⣠⣤⣤⣤⣤⣄     ⣠⣤⣤⣤⣤⣄     ⣠⣤⣤⣤⣤⣄     ⣠⣤⣤⣤⣤⣄     ⣠⣤⣤⣤⣤⣄    ⣿⠋⠉⠉⠉⠙⣿          ╭─╯  ╭─╯       ╰─╮                                                                                                                                   │    ╭──────────────────────╮◺◺  │                              │
│                         ████████                       ████████      ▓░▓     ████████                  ████████      ░                                                  └──────────┘                                                            │        │                 ╭─╯           ╰──╮ ╰──╮       ⣿⠀⠀⠀⠀⠀⣿    ⣿⣿⣿⣿⣿⣿     ⣿⣿⣿⣿⣿⣿     ⣿⣿⣿⣿⣿⣿     ⣿⣿⣿⣿⣿⣿     ⣿⣿⣿⣿⣿⣿     ⣿⣿⣿⣿⣿⣿     ⣿⣿⣿⣿⣿⣿     ⣿⣿⣿⣿⣿⣿     ⣿⣿⣿⣿⣿⣿     ⣿⣿⣿⣿⣿⣿     ⣿⣿⣿⣿⣿⣿     ⣿⣿⣿⣿⣿⣿     ⣿⣿⣿⣿⣿⣿     ⣿⣿⣿⣿⣿⣿     ⣿⣿⣿⣿⣿⣿     ⣿⣿⣿⣿⣿⣿     ⣿⣿⣿⣿⣿⣿     ⣿⣿⣿⣿⣿⣿    ⣿⠀   ⠀⣿       ╭──╯ ╭──╯           ╰─╮                                                                                                                                 │    │  ▟█▙    ▟██▙    ▟█▙  │ ◸◸◸│                              │
│                         ▀▀▀▜▛▀▀▀                       ▀▀▀▜▛▀▀▀   █  ▓░▓  █  ▀▀▀▜▛▀▀▀                  ▀▀▀▜▛▀▀▀   █▘ ░                               ┌──────────┐                                                                   █▘          │        │               ╭─┴╮               ╰────╯       ⣿⣄⣀⣀⣀⣠⣿    ⣿⣿⣿⣿⣿⣿     ⣿⣿⣿⣿⣿⣿     ⣿⣿⣿⣿⣿⣿     ⣿⣿⣿⣿⣿⣿     ⣿⣿⣿⣿⣿⣿     ⣿⣿⣿⣿⣿⣿     ⣿⣿⣿⣿⣿⣿     ⣿⣿⣿⣿⣿⣿     ⣿⣿⣿⣿⣿⣿     ⣿⣿⣿⣿⣿⣿     ⣿⣿⣿⣿⣿⣿     ⣿⣿⣿⣿⣿⣿     ⣿⣿⣿⣿⣿⣿     ⣿⣿⣿⣿⣿⣿     ⣿⣿⣿⣿⣿⣿     ⣿⣿⣿⣿⣿⣿     ⣿⣿⣿⣿⣿⣿     ⣿⣿⣿⣿⣿⣿    ⣿⣄⣀⣀⣀⣠⣿       ╰────╯               ╭┴─╮                                                                                                                               │    │ ▟███▙  ▟████▙  ▟███▙ │    │                              │
│                    ══╦═════▝▘══════════╦══        ══╦═════▝▘════════════════════▝▘═════╦══        ══╦═════▝▘══════════╦══                            │ □ □  □ □ │                                                   ══╦═════════════════╦══     │      ◯ │             ╭─╯  ╰─╮                          ⣿⣿⣿⣿⣿⣿⣿    ⢿⣿⣿⣿⣿⡿     ⢿⣿⣿⣿⣿⡿     ⢿⣿⣿⣿⣿⡿     ⢿⣿⣿⣿⣿⡿     ⢿⣿⣿⣿⣿⡿     ⢿⣿⣿⣿⣿⡿     ⢿⣿⣿⣿⣿⡿     ⢿⣿⣿⣿⣿⡿     ⢿⣿⣿⣿⣿⡿     ⢿⣿⣿⣿⣿⡿     ⢿⣿⣿⣿⣿⡿     ⢿⣿⣿⣿⣿⡿     ⢿⣿⣿⣿⣿⡿     ⢿⣿⣿⣿⣿⡿     ⢿⣿⣿⣿⣿⡿     ⢿⣿⣿⣿⣿⡿     ⢿⣿⣿⣿⣿⡿     ⢿⣿⣿⣿⣿⡿    ⣿⣿⣿⣿⣿⣿⣿                          ╭─╯  ╰─╮                                                                                                                             │    │ █████  ██████  █████ │    │                              │
│                      ║                 ║            ║                                  ║            ║                 ║           ┌──────────┐       │          │                                                     ║                 ║       │        │           ╭─╯      ╰─╮                        ⣿⣿⣿⣿⣿⣿⣿                                                                                                                                                                                                         ⣿⣿⣿⣿⣿⣿⣿                        ╭─╯      ╰─╮                                                                                                                           │    │ █████  ██████  █████ │    │                              │
│                      ║                 ║            ║                                  ║            ║                 ║           │ □ □  □ □ │       └──────────┘                                                     ║                 ║       │        │           │          ╰─╮                      ⢿⣿⣿⣿⣿⣿⡿                                                                                                                                                                                                         ⣿⣿⣿⣿⣿⣿⣿                      ╭─╯          │                                                                                                                           │    │ █████  ██████  █████ │    │                              │
│                      ║                 ║            ║                                  ║            ║                 ║           │          │                                                                        ║                 ║       │        │           │            ╰─╮                    ⠀⠀⠀⠀⠀⠀⠀                                                                                                                                                                                                         ⢿⣿⣿⣿⣿⣿⡿                    ╭─╯            │                                                                                                                           │    │ █████  ██████  █████ │    │                              │
│                      ╨                 ╨            ╨                                  ╨            ╨                 ╨           └──────────┘                                                                        ╨                 ╨       │        │           ╰──────────────┴┬───┬───┬───┬───────────────────────────────────────────────────────┬───┬───┬───┬─────────────────────────────────────────────────────────────────────────────────────────────┬───┬───┬───┬───────────────────────────────────────────────────────┬───┬───┬───┬┴──────────────╯                                                                                                                           ╰────┴─▀▀▀▀▀──▀▀▀▀▀▀──▀▀▀▀▀─┴────╯                              │
│                                                                                                                                                                                                                                                 └────────┘                           ╰◯◯◯╯   ╰◯◯◯╯                                                       ╰◯◯◯╯   ╰◯◯◯╯                                                                                             ╰◯◯◯╯   ╰◯◯◯╯                                                       ╰◯◯◯╯   ╰◯◯◯╯                                                                                                                                                                                                           │
└────────────────────────────────────────────────────────────────────────────────────────────────────────────────────────────────────────────────────────────────────────────────────────────────────────────────────────────────────────────────────────────────────────────────────────────────────────────────────────────────────────────────────────────────────────────────────────────────────────────────────────────────────────────────────────────────────────────────────────────────────────────────────────────────────────────────────────────────────────────────────────────────────────────────────────────────────────────────────────────────────────────────────────────────────────────────────────────────────────────────────────────────┘