┌────────────────┬──────────────────────────────────────────────────┬────────────────────────────────────────────────┬─────────────────────────────────────────┐
│                │                                                  │                                                │                                         │
│                │                                                  │                                                │                                         │
│              .─┴─.                                              .─┴─.                                            .─┴─.                                       │
│             (     )                                            (     )                                          (     )                                      │
│              '───'                                              '───'                                            '───'                                       │
│                                                                                                                                                              │
│                                                                                                                                                              │
│         ┌────────────────────────────────┐     ┌────────────────────────────────┐     ┌────────────────────────────────┐                                     │
│         │                                │     │                                │     │                     ▷▷         │                                     │
│         │  ╔═════╗   ═══╦═══  ╔══════╗   │     │  ╔═════╗   ═══╦═══  ║║  ║║     │     │                     ▷ ▷▷       │                                     │
│         │  ║     ║      ║     ║      ║   │     │  ║     ║      ║     ║║  ║║     │     │  ▷▷▷▷▷▷▷▷▷▷▷▷▷▷▷▷▷▷▷▷   ▷▷     │                                     │
│         │  ║            ║     ║      ║   │     │  ║     ║      ║     ║║  ║║     │     │  ▷                        ▷▷   │                                     │
│         │  ╚═════╗      ║     ╠══════╣   │     │  ╠═══╦═╝      ║     ║║  ║║     │     │  ▷▷▷▷▷▷▷▷▷▷▷▷▷▷▷▷▷▷▷▷   ▷▷     │                                     │
│         │        ║      ║     ║      ║   │     │  ║   ╚═╗      ║                │     │                     ▷ ▷▷       │                                     │
│         │  ╚═════╝      ║     ║      ║   │     │  ║     ║      ║     ║║  ║║     │     │                     ▷▷         │                                     │
│         └────────────────────────────────┘     └────────────────────────────────┘     └────────────────────────────────┘                                     │
│                                                                                                                                                              │
│                                                                                                                                                              │
│                                                                                                                                                              │
│                      ████████                       ████████              ████████                  ████████                                                 │
│                      ████████      ░                ████████      ▓░▓     ████████                  ████████      ░                                          │
│                      ▀▀▀▜▛▀▀▀   █▘ ░                ▀▀▀▜▛▀▀▀   █  ▓░▓  █  ▀▀▀▜▛▀▀▀                  ▀▀▀▜▛▀▀▀   █▘ ░                                          │
│                 ══╦═════▝▘══════════╦══        ══╦═════▝▘════════════════════▝▘═════╦══        ══╦═════▝▘══════════╦══                                       │
│                   ║                 ║            ║                                  ║            ║                 ║                                         │
│                   ║                 ║            ║                                  ║            ║                 ║                                         │
│                   ║                 ║            ║                                  ║            ║                 ║                                         │
│                   ╨                 ╨            ╨                                  ╨            ╨                 ╨                                         │
│                                                                                                                                                              │
└──────────────────────────────────────────────────────────────────────────────────────────────────────────────────────────────────────────────────────────────┘